interrupt
An Interactive Fiction by Chase Anderson
Release 1 / Serial number 250618 / Inform 7 v10.1.2 / D

Restaurant
Turns out the "bottomless mimosas" have a bottom. It's when the servers keep finding convenient reasons to never swing by your table again.

It's a real shame, because you really want to drain your current drink right now.

Granted, they might also be giving you a wide bearth because your friend is crying and they don't want to get involved. You, honestly, would rather not be involved, either, but this isn't a situation you can easily remove yourself from.

But you can only say "I'm sorry" so many times before it sounds like you don't actually care. descrip for no matter what.

Szofia1 init.

>i
You are carrying:
  blazer (being worn and closed)
  testWidget1

>open blazer
You open blazer, revealing pillCase.

>s
before test string.

TestRoom2
This is TestRoom2 init descript.

>i
You are carrying:
  jacket (being worn and closed)
  testWidget

>open jacket
You open jacket.

* * *

>i
You are carrying:
  blazer (being worn and closed)
  testWidget1

>x self
TODO: self descri. Needs blazer + chest/hands. needs if to be diff from room 1.

>inspect testWidget1
TODO: You inspect the testWidget1, so now it's inspected.

>look
Restaurant
This is the Restaurant init descript.

>scene
That's not a verb I recognise.

>inspect testWidget1
You see nothing special about testWidget1.

* * *

>x self
TODO: self descri. Needs blazer + chest/hands. needs if to be diff from room 1.

this is brunch time.

>x blazer
TODO: blazer descri.

>i
You are carrying:
  blazer (being worn and closed)
  jacket (being worn and closed)

* * *

>x blazer
TODO: blazer descri.

>open blazer
You open blazer, revealing pill case, your phone and your notebook.

>x notebook
TODO: notebook1 descri.

>s
before test string.

TestRoom2
This is TestRoom2 init descript.

>restart
Are you sure you want to restart?

>y
interrupt
An Interactive Fiction by Chase Anderson
Release 1 / Serial number 250618 / Inform 7 v10.1.2 / D

TestRoom
This is the test room init descript.

>i
You are carrying:
  blazer (being worn and closed)
  testWidget1

>o blazer
Sorry, that can't be corrected.

>restart
Are you sure you want to restart?

* * *

>i
You are carrying:
  blazer (being worn and closed)
  testWidget1

>open blazer
You open blazer, revealing pill case, your phone and your notebook.

* * *

>s
before test string.

TestRoom2
This is TestRoom2 init descript.

>i
You are carrying:
  testWidget2
  jacket (being worn and closed)

>open jacket
You open jacket, revealing your phone, pill case and your notebook.

>x notebook
TODO: notebook2 descri.

* * *

>x self
TODO: self descri. Needs blazer + chest/hands. needs if to be diff from room 1.

this is brunch time.

>x hands
TODO: hand descri.needs if to be diff from room 1.

>x chest
TODO: chest descrineeds if to be diff from room 1..

>open blazer
You open blazer, revealing pill case, your phone and your notebook.

>x pill case
You can't see any such thing.

>o pill case
"Oops" can only correct a single word.

>open pill case
You can't see any such thing.

>take pill case
You can't see any such thing.

>wait
Time passes.

>wait
Time passes.

>turn
What do you want to turn?

>time
You can't see any such thing.

>check time
You can't see any such thing.

>look
Restaurant
This is the Restaurant init descript.

>wait
Time passes.

>look
Restaurant
This is the Restaurant init descript.

>time
That's not a verb I recognise.

>check time
You can't see any such thing.

* * *

>x self
TODO: self descri. Needs blazer + chest/hands. needs if to be diff from room 1.

this is brunch time.

>x chest
TODO: chest descrineeds if to be diff from room 1..

* * *

>open blazer
You open blazer, revealing pill case, your phone and your notebook.

>open pill case
You can't see any such thing.

* * *

>take pill case
You can't see any such thing.

>take pillCase
Taken.

>open pillCase
You open pill case, revealing the blue pill and pain pills.

>eat blue pill
(first taking the blue pill)
You eat the blue pill. Not bad.

>wait
Time passes.

* * *

>look
Restaurant
This is the Restaurant init descript.

>turn count
You can't see any such thing.

>turns
That's not a verb I recognise.

* * *

>x self
TODO: self descri. Needs blazer + chest/hands. needs if to be diff from room 1.

this is brunch time.

>i
You are carrying:
  blazer (being worn and closed)
  testWidget1

>x testWidget1
You see nothing special about testWidget1.

>insepct testWidget1
That's not a verb I recognise.

>inspect
What do you want to inspect?

>inspect blazer
TODO: this is uninspectable

>inspect testWidget1
TODO: this is uninspectable

* * *

>i
You are carrying:
  blazer (being worn and closed)
  testWidget1

>inspect testWidget1
*** Run-time problem P10: Since testWidget1 is not allowed the property "open", it is against the rules to try to use it.

TODO: You inspect the testWidget1, so now it's inspected.

>look
Restaurant
This is the Restaurant init descript.

>i
You are carrying:
  blazer (being worn and closed)
  testWidget1

* * *

>x self
TODO: self descri. Needs blazer + chest/hands. needs if to be diff from room 1.

this is brunch time.

>inspect testWidget1
TODO: You inspect the testWidget1, so now it's inspected.

now youre moving ooooo.

Car
This is car init descript.

this is driving time.

* * *

>wait
Time passes.

this is brunch time.

>wait
Time passes.

this is brunch time.

>wait
Time passes.

this is brunch time.

Szofia sighs, a heavy, exaggerated motion that makes her body shudder.

"I'm sorry to have dragged you into this, it's just that"
Car
 This is car init descript but fucky.

>wait
Time passes.

this is driving time.

>look
Restaurant
This is the Restaurant init descript.

>[scene 'Brunch' ends]
That's not a verb I recognise.

>scene 'Brunch' ends
That's not a verb I recognise.

* * *

>wait
Time passes.

this is driving time.

I beg your pardon?

>x self
TODO: self descri. Needs blazer + chest/hands. needs if to be diff from room 1.

this is driving time.

>i
You are carrying:
  testWidget2
  jacket (being worn and closed)

this is driving time.

>open jacket
You open jacket, revealing your phone, pill case and your notebook.

this is driving time.

* * *

>wait
Time passes.

this is brunch time.

Szofia sighs, a heavy, exaggerated motion that makes her body shudder.

"I'm sorry to have dragged you into this, it's just that"
Car
 This is car init descript but fucky.

>look
Car
 this should be the second card innit.

this is driving time.

>look
Car
 this should be the second card innit.

this is driving time.

* * *

>ask szofia about test1
test1 response.
this is brunch time.

>look
Restaurant
This is the Restaurant init descript.

Szofia1 init.

this is brunch time.

>talk to Szofia about testWidget2
You can't see any such thing.

>ask Szofia about testWidget1
You can't see any such thing.

>talk to Szofia
You can't see any such thing.

* * *

>ask szofia about test1
test1 response.
this is brunch time.

>ask szofia about testWidget2
i dont care for test widget one.
this is brunch time.

>ask szofia about testWidget1
i dont care for test widget one.
this is brunch time.

>ask szofia about boyfriend
"I think this might be it for us," Szofia says. "I know he's told me so many times to not talk about my work with him, but...it's difficult when I get excited. Do you understand?

You don't really, but you still nod an affirmative. You've dealt with your fair share of dead bodies over the course of both of your careers, but interacting with them is never a pleasant experience. You can at least tolerate them.

Szofia is something different, however. But an ME that didn't find corpses fascinating wouldn't get very far in the field, you think.
this is brunch time.

>ask szofia about me
(Szofia Meszaros)
You ask Szofia Meszaros about Szofia Meszaros and got this TODO: text.

this is brunch time.

>ask szofia about amira
You ask Szofia Meszaros about yourself and got this TODO: text.

this is brunch time.

>ask szofia about yourself
You ask Szofia Meszaros about your former self and got this TODO: text.

this is brunch time.

>ask szofia about szofia
You ask Szofia Meszaros about Szofia Meszaros and got this TODO: text.

this is brunch time.

* * *

>ask szofia about boyfriend
"I think this might be it for us," Szofia says. "I know he's told me so many times to not talk about my work with him, but...it's difficult when I get excited. Do you understand?

You don't really, but you still nod an affirmative. You've dealt with your fair share of dead bodies over the course of both of your careers, but interacting with them is never a pleasant experience. You can at least tolerate them.

Szofia is something different, however. But an ME that didn't find corpses fascinating wouldn't get very far in the field, you think.
this is brunch time.

>wait
Time passes.

this is brunch time.

I beg your pardon?

>wait
Time passes.

this is brunch time.

* * *

I beg your pardon?

>wait
Time passes.

this is brunch time.

Szofia sighs, a heavy, exaggerated motion that makes her body shudder.

"I'm sorry to have dragged you into this, it's just that"
Car
 This is car init descript but fucky.

* * *

>x szofia
She easily could have easily been a model, or a princess at a theme park, but Dr. Szofia Meszaros decided she'd rather make a career from examining dead bodies instead.

There are multiple MEs who work out of your field office, but you prefer working with Szofia. Happy, upbeat, doesn't ask too many questions about what, exactly, it is you do and why you ask such specific questions.

She's the closest thing you have to a friend, and, with her name already attached to so many of your reports, being seen in public with her shouldn't make her any more likely a target.

At least she doesn't have kids that would miss her if the worst happens, just the boyfriend who doesn't seem like he'll last.

this is brunch time.

>talk to szofia about test1
test1 response.
this is brunch time.

>ask szofia about testWidget2
i dont care for test widget one.
this is brunch time.

>talk to szofia about testWidget2
i dont care for test widget one.
this is brunch time.

>talk to szofia about testWidget1
i dont care for test widget one.
this is brunch time.

>talk to szofia about testWidget2
i dont care for test widget one.
this is brunch time.

>x testWidget1
You see nothing special about testWidget1.

this is brunch time.

>wait
Time passes.

this is brunch time.

>wwait
That's not a verb I recognise.

>wait
Time passes.

this is brunch time.

now youre moving ooooo.

Car
This is car init descript.

>x testWidget2
You see nothing special about testWidget2.

this is driving time.

* * *

>talk to sophia about ME
You can't see any such thing.

>talk to szofia about boyfriend
"I think this might be it for us," Szofia says. "I know he's told me so many times to not talk about my work with him, but...it's difficult when I get excited. Do you understand?

You don't really, but you still nod an affirmative. You've dealt with your fair share of dead bodies over the course of both of your careers, but interacting with them is never a pleasant experience. You can at least tolerate them.

Szofia is something different, however. But an ME that didn't find corpses fascinating wouldn't get very far in the field, you think.
this is brunch time.

>talk to szofia about faily
That noun did not make sense in this context.

>talk to szofia about family
At this, Szofia visibly deflates.

"He hasn't shown any interest in seeing mine... Even after I told him I'd pay for everything! But that started another fight..."

"Perhaps he's not a fan of the cold?" you offer.

"Which is why I suggested we go for midsummer. It would make up for the lack of sun we get here." Szofia gestures skyward, despite the unusually sunny day out.

Perhaps he had seen the movie and gotten the wrong idea. Or perhaps he didn't want to spend seventeen-plus hours in an airplane to travel to an obscure Nordic region most have never heard of.
this is brunch time.

>talk to szofia about family amira
I only understood you as far as wanting to talk to Szofia Meszaros about family.

>talk to szofia about amira
Szofia blinks, waits a moment, and then laughs.

"You always ask me the strangest questions, Amira! I don't think I can tell you anything about yourself that you don't already know."
this is brunch time.

>talk to szofia about szofia
(Szofia Meszaros)
She blinks.

"What a strange question," she says. "I'm the same Dr. Meszaros that you've always known."

You have to suppress your smile. All things in the universe are in a constant state of change, moment by moment, so no two things are ever quite the same as they once were. But brunch is hardly the place to discuss the realities of metaphysics.
this is brunch time.

>look
Restaurant
 else descrip.  descrip for no matter what.

Szofia1 init.

this is brunch time.

>look
Restaurant
 else descrip.  descrip for no matter what.

Szofia1 init.

this is brunch time.

>x self
TODO: self descri. Needs blazer + chest/hands. needs if to be diff from room 1.

this is brunch time.

>open blazer
You open blazer, revealing pill case, your phone and your notebook.

this is brunch time.

>x blazer
TODO: blazer descri.

In blazer are pill case, your phone and your notebook.

this is brunch time.

Szofia sighs, a heavy, exaggerated motion that makes her body shudder.

"I'm sorry to have dragged you into this, it's just that"
Car
 "versary was today and-AIEEEEE!"

The shriek snapps your attention to the present, the oncoming car. A visceral reaction jerks the steering wheel to the right, landing you both past the dirt shoulder and into the grass. The other car zooms by, unbothered.

"Sorry, I..." The patter of heavy rain resounds off of the car's roof.Between the trees and the mist, you can't make out any landmarks or signs to denote where you are. You are in the middle of nowhere.

szofia 2 innit descrip.

>x trees
Thick trees line either side of the road. The coniferous rainforest's trees and rain block the existence of any other humans that might have ever existed.

It's the perfect setting for countless strange tales, when an FBI agent is called out to the middle of nowhere to investigate an unsolvable murder. You've always suspected that this might happen to you, and it seems that the universe has decided today would be that day.

this is driving time.

>outside
SideOfRoad
outside of the car innit descrip.

this is driving time.

>inside
You can't go that way.

this is driving time.

>go inside
You can't go that way.

this is driving time.

>inside
You can't go that way.

this is driving time.

* * *

>ask szofia about boyfriend
"I think this might be it for us," Szofia says. "I know he's told me so many times to not talk about my work with him, but...it's difficult when I get excited. Do you understand?

You don't really, but you still nod an affirmative. You've dealt with your fair share of dead bodies over the course of both of your careers, but interacting with them is never a pleasant experience. You can at least tolerate them.

Szofia is something different, however. But an ME that didn't find corpses fascinating wouldn't get very far in the field, you think.
this is brunch time.

>ask szofia about your partner
"What would you do...?" Szofia asks tearfully. Her mascara is running, but it's a warm, sunny Sunday morning, perhaps it was from the heat instead?

You think how odd it is to be faced with such an emotional situation and not feeling a similar level of anguish.

"I haven't had a partner since I started," you say. "Professional or otherwise."

"But what about your dates? Surely, they must get frustrated when you..." Szofia trails off, already realizing the answer.

"I don't want to make anyone a target that doesn't need to be," you say.
this is brunch time.

>ask sofia about past work
You can't see any such thing.

>ask szofia about past work
The current situation is not about you, and you don't want to change that. Regardless, it wouldn't be safe to discuss it in such a public place.
this is brunch time.

>ask szofia about pill case
You only carry two kinds of pills on you, and neither would be of much use in this situation, so you don't bring up the subject.
this is brunch time.

>ask szofia about blue pill
You both know that it doesn't have much effect on cis women, and, based on the TMI conversations you've been subjected to, you have no reason to believe Szofia is anything but.

Besides, this is hardly the time or place for such a proposition.
this is brunch time.

>ask szofia about pain pills
There is no reply.

this is brunch time.

>ask szofia about pain pill
These are for physical pain, not emotional, so it would be of little use in this situation, so you don't mention it.
this is brunch time.

>ask szofia about yourself
You consider asking Szofia Meszaros about the your former self and got this TODO: error text (maybe dont ask them lol).

this is brunch time.

>ask szofia about me
(medEx)
You consider asking Szofia Meszaros about the medEx and got this TODO: error text (maybe dont ask them lol).

this is brunch time.

>ask szofia about player
There is no reply.

this is brunch time.

Szofia sighs, a heavy, exaggerated motion that makes her body shudder.

"I'm sorry to have dragged you into this, it's just that"
Car
 This is car init descript but fucky.

* * *

>ask szofia about amira
Szofia blinks, waits a moment, and then laughs.

"You always ask me the strangest questions, Amira! I don't think I can tell you anything about yourself that you don't already know."
this is brunch time.

>ask szofia about herself
There is no reply.

this is brunch time.

>ask szofia about szofia
She blinks.

"What a strange question," she says. "I'm the same Dr. Meszaros that you've always known."

You have to suppress your smile. All things in the universe are in a constant state of change, moment by moment, so no two things are ever quite the same as they once were. But brunch is hardly the place to discuss the realities of metaphysics.
this is brunch time.

>ask szofia about family
At this, Szofia visibly deflates.

"He hasn't shown any interest in seeing mine... Even after I told him I'd pay for everything! But that started another fight..."

"Perhaps he's not a fan of the cold?" you offer.

"Which is why I suggested we go for midsummer. It would make up for the lack of sun we get here." Szofia gestures skyward, despite the unusually sunny day out.

Perhaps he had seen the movie and gotten the wrong idea. Or perhaps he didn't want to spend seventeen-plus hours in an airplane to travel to an obscure Nordic region most have never heard of.
this is brunch time.