A (Partial) Day as a Platypus
An Interactive Fiction by Chase Anderson
Release 1 / Serial number 250704 / Inform 7 v10.1.2 / D

Apartment
  You are awoken by the shriek of your alarm. Your paw slaps around for the snooze button, condensation collecting on the webbings. Finally, you find your mark, and the whistling steam quiets.

You're tempted to fall back asleep, but you recall the tenuous status you have with your boss. So, you pull yourself out of your bed to view your single-room home once more. It isn't much, but you don't want to lose it.

 There's a corner for your bathroom-slash-kitchen, complete with a washing basin atop a safe. There's also a brick fireplace, a small bookshelf, your bed, and your alarm clock. There is an additional steam hookup, currently unused. And, of course, the door that leads you OUTSIDE your apartment.

>look
Apartment
  There's a corner for your bathroom-slash-kitchen, complete with a washing basin atop a safe. There's also a brick fireplace, a small bookshelf, your bed, and your alarm clock. There is an additional steam hookup, currently unused. And, of course, the door that leads you OUTSIDE your apartment.

>go outside
Street
this is placeholder for street.

>go south
Office
this is placeholder for office.

>where
That's not a verb I recognise.

>look
Office
this is placeholder for office.

>go inside
Cyberspace
this is placeholder for cyberspace.

>go outside
Office
this is placeholder for office.

>go  south
You can't go that way.

>go office
You can't see any such thing.

* * *

>look
Apartment
  There's a corner for your bathroom-slash-kitchen, complete with a washing basin atop a safe. There's also a brick fireplace, a small bookshelf, your bed, and your alarm clock. There is an additional steam hookup, currently unused. And, of course, the door that leads you OUTSIDE your apartment.

>north
You bump into the wall. You are swiftly reminded of how sensitive your beak is, and why it isn't a good idea to run into walls.

>outside
Street
  When you first saw the listing for an apartment on Telegraph Ave, you thought it was a wonderful idea. Night markets! Plays! All the bars a young platypus could ever want to visit!

That was before you got your night shift job. Now, all the activity is merely a reminder of all the things you are no longer able to do. Most of the other nocturnal animals in your city had chosen elsewhere to live, where most of the inhabitants were away at work and they could sleep in peace.

Telegraph was busy at all hours, which made finding sleep difficult.

  A tram stops and a stream of creatures jump off, scattering in each direction as they headed to their evening activities. You plan to jump on yourself, but it takes off before you have the chance.

It seems like you'll need to walk to work tonight.

 Across the street to the WEST is the cafe you often frequent. If you continue SOUTH, you'll reach your office building.

>look
Street
   A young bat stumbles on the sidewalk, calling out for buyers for the evening edition of the paper. He's emoting with his wings, which draws attention, but gives everyone reason to avoid him to stay out of range.

You decide to do the same.

 Across the street to the WEST is the cafe you often frequent. If you continue SOUTH, you'll reach your office building.

>look
Street
   A tram stops and a stream of creatures jump off, scattering in each direction as they headed to their evening activities. You plan to jump on yourself, but it takes off before you have the chance.

It seems like you'll need to walk to work tonight.

 Across the street to the WEST is the cafe you often frequent. If you continue SOUTH, you'll reach your office building.

>look
Street
   A young bat stumbles on the sidewalk, calling out for buyers for the evening edition of the paper. He's emoting with his wings, which draws attention, but gives everyone reason to avoid him to stay out of range.

You decide to do the same.

 Across the street to the WEST is the cafe you often frequent. If you continue SOUTH, you'll reach your office building.

>north
  You walk for a short while, but are stopped by a road closure. It seems that some hapless laborer had dug without consulting city hall first, resulting in a damaged steam line...and most of the road being torn up.

You turn around and go back to your previous position.

>north
  You decide this would be a great evening to look for a shortcut to the office. You slip down an alleyway, but don't make it very far, as someone had decided this would make an excellent dumping ground for old furniture.

You make a note to tell your vulture friend later, and then turn around and return to the street.

>north
  You're running out of directions to go that are not the office. While slipping into the nearby bar for a drink is a compelling option, paying your rent takes priority.

You dejectedly shove your paws into your pockets and turn around.

>north
  You're running out of directions to go that are not the office. While slipping into the nearby bar for a drink is a compelling option, paying your rent takes priority.

You dejectedly shove your paws into your pockets and turn around.

>west
Cafe
 The bell above the door tinkles as you step inside.

 "G'day," says the clerk behind the counter, with a big smile.

A couple patrons glance at you, likely wondering if the weasel was making fun of you. But you've been going here for years, so you chalk it up to fitting the "Australis" theme than anything else.

 While you were indeed hungry, you didn't have the time to kick your webs up and relax, so you better get going if you planned on not angering your boss.

The cafe has several patrons sitting at different tables, a clerk standing behind the counter, and the door to leave in the EAST. You can't help but notice the leyline jack is left unguarded. You're so amazing that you can go INSIDE the leyline network without an item (as you have yet to learn how to use items).

>look
Cafe
 The bell above the door tinkles as you step inside.

 "G'day again," the clerk chirps, and then giggles. "Changed your mind, huh? What can I get you?"

Unfortunately, you have still never learned how to speak, so you cannot answer her.

 While you were indeed hungry, you didn't have the time to kick your webs up and relax, so you better get going if you planned on not angering your boss.

The cafe has several patrons sitting at different tables, a clerk standing behind the counter, and the door to leave in the EAST. You can't help but notice the leyline jack is left unguarded. You're so amazing that you can go INSIDE the leyline network without an item (as you have yet to learn how to use items).

>look
Cafe
 The bell above the door tinkles as you step inside.

 "Hey," the clerk says. "You feeling okay? If you need a glass of water or something, you can just ask."

You still don't answer her, which she acknowledges by glancing away nervously. She busies herself with something behind the counter you can't see.

 While you were indeed hungry, you didn't have the time to kick your webs up and relax, so you better get going if you planned on not angering your boss.

The cafe has several patrons sitting at different tables, a clerk standing behind the counter, and the door to leave in the EAST. You can't help but notice the leyline jack is left unguarded. You're so amazing that you can go INSIDE the leyline network without an item (as you have yet to learn how to use items).

>look
Cafe
 The bell above the door tinkles as you step inside.

 "Oh." The clerk glances up at you, gives you a moment to respond, and then turns her back to deal with something you can't see.

You won't be able to speak to her like this.

 While you were indeed hungry, you didn't have the time to kick your webs up and relax, so you better get going if you planned on not angering your boss.

The cafe has several patrons sitting at different tables, a clerk standing behind the counter, and the door to leave in the EAST. You can't help but notice the leyline jack is left unguarded. You're so amazing that you can go INSIDE the leyline network without an item (as you have yet to learn how to use items).

>look
Cafe
 The bell above the door tinkles as you step inside.

 The clerk glances over her shoulder at you, but quickly returns to her work, ignoring you.

You have the feeling you've lost your chance to speak to her.

 While you were indeed hungry, you didn't have the time to kick your webs up and relax, so you better get going if you planned on not angering your boss.

The cafe has several patrons sitting at different tables, a clerk standing behind the counter, and the door to leave in the EAST. You can't help but notice the leyline jack is left unguarded. You're so amazing that you can go INSIDE the leyline network without an item (as you have yet to learn how to use items).

>look
Cafe
 The bell above the door tinkles as you step inside.

 The clerk glances over her shoulder at you, but quickly returns to her work, ignoring you.

You have the feeling you've lost your chance to speak to her.

 While you were indeed hungry, you didn't have the time to kick your webs up and relax, so you better get going if you planned on not angering your boss.

The cafe has several patrons sitting at different tables, a clerk standing behind the counter, and the door to leave in the EAST. You can't help but notice the leyline jack is left unguarded. You're so amazing that you can go INSIDE the leyline network without an item (as you have yet to learn how to use items).

>north
You consider it, but decide not to. It would be unwise to plow into someone's table and ruin their supper.

>inside
Network
  You'll probably never get used to the feeling of tumbling inside-out that always happens whenever you connect to the network...with your mind, because you're so amazing that you don't need items.

 The leyline network is an abstract space, colors and intent swirling in place until a current of energy might rush by and take it from one place to another.

You're one of the lucky few that is able to visualize this space...but not lucky enough to have the aptitude to actually create the spells yourself. Instead, you're nothing more than a glorified guard, poking at suspicious-looking tidepools to find anything that might not supposed to be there.

There are various areas of color you could inspect, but you don't seem to recall how to do that. The only action you're able to leave is by going OUTSIDE of the network.

>look
Network
  The leyline network is an abstract space, colors and intent swirling in place until a current of energy might rush by and take it from one place to another.

You're one of the lucky few that is able to visualize this space...but not lucky enough to have the aptitude to actually create the spells yourself. Instead, you're nothing more than a glorified guard, poking at suspicious-looking tidepools to find anything that might not supposed to be there.

There are various areas of color you could inspect, but you don't seem to recall how to do that. The only action you're able to leave is by going OUTSIDE of the network.

>outside
Office
  You're able to punch in just in time; your boss won't be able to accuse you of being late this time!

 As you were never taught how to speak, you do not run into any creatures on the way to your closet. Lucky you!

Unlike other animals, you don't mind the dark, enclosed space of the networking closet. The softly-glowing cords of the leyline network create glittering afterimages if you look at one spot for too long.

You have tasks that are your duty to perform, but you aren't capable of remembering what they are.

You're so amazing that you can go INSIDE the leyline network without an item (as you have yet to learn how to use items.). You can also leave the office by going NORTH.

* * *

>look
Apartment
  There's a corner for your bathroom-slash-kitchen, complete with a washing basin atop a safe. There's also a brick fireplace, a small bookshelf, your bed, and your alarm clock. There is an additional steam hookup, currently unused. And, of course, the door that leads you OUTSIDE your apartment.

>examine alarm
A steam-powered alarm clock. The newest model, it cost you a pretty penny, but it means you always wake up in time for work.

Your neighbors aren't super appreciative of this modern convenience, though. Probably because they keep entirely different hours than you do.

Alarm clock is currently switched off.

>examine clock
A steam-powered alarm clock. The newest model, it cost you a pretty penny, but it means you always wake up in time for work.

Your neighbors aren't super appreciative of this modern convenience, though. Probably because they keep entirely different hours than you do.

Alarm clock is currently switched off.

>examine alarm clock
A steam-powered alarm clock. The newest model, it cost you a pretty penny, but it means you always wake up in time for work.

Your neighbors aren't super appreciative of this modern convenience, though. Probably because they keep entirely different hours than you do.

Alarm clock is currently switched off.

>take clock
That's hardly portable.

>ON alarm clock
That's not a verb I recognise.

>switch on clock
You switch alarm clock on.

>examine clock
A steam-powered alarm clock. The newest model, it cost you a pretty penny, but it means you always wake up in time for work.

Your neighbors aren't super appreciative of this modern convenience, though. Probably because they keep entirely different hours than you do.

Alarm clock is currently switched on.

* * *

>look
Apartment
  There's a corner for your bathroom-slash-kitchen, complete with a washing basin atop a safe. There's also a brick fireplace, a small bookshelf, your bed, and your alarm clock. There is an additional steam hookup, currently unused. And, of course, the door that leads you OUTSIDE your apartment.

>examine bed
Your bed, big enough for one not-too-large creature. The covers are askew, but, as you were never taught how to make the bed, it will need to remain messy for the time being.

>enter bed
You get into bed.

>leave bed
I only understood you as far as wanting to leave.

>exit bed
I only understood you as far as wanting to exit.

>unenter bed
That's not a verb I recognise.

>out bed
I only understood you as far as wanting to out.

>outside
You would have to get out of bed first.

>get out bed
I only understood you as far as wanting to get outside.

>get out of the bed
I only understood you as far as wanting to get outside.

>exit bed
I only understood you as far as wanting to exit.

>exit
You get out of bed.

Apartment
  There's a corner for your bathroom-slash-kitchen, complete with a washing basin atop a safe. There's also a brick fireplace, a small bookshelf, your bed, and your alarm clock. There is an additional steam hookup, currently unused. And, of course, the door that leads you OUTSIDE your apartment.

>examine safe
A pie safe. The tin panels on the front have holes punched in the design of eucalyptus trees.

>open safe
You open safe, revealing pie.

>examine pie
A personal-sized mealworm pot pie. Makes a perfect start for your day-slash-night.

>take pie
Taken.

>inventory
You are carrying:
  pie

>i
You are carrying:
  pie

>examine sink
You can't see any such thing.

>elook sink
That's not a verb I recognise.

>look sink
You can't see any such thing.

>look basin
You can't see any such thing.

>examine basin
You can't see any such thing.

* * *

>go outside
Street
this is placeholder for street.

* * *

>go south
Office
this is placeholder for office.

>go inside
Cyberspace
this is placeholder for cyberspace.

* * *

>go outside
Office
this is placeholder for office.

>go north
Street
this is placeholder for street.

>go inside
Apartment
  There's a corner for your bathroom-slash-kitchen, complete with a washing basin atop a pie safe. There's also a brick fireplace, a small bookshelf, your bed, and your alarm clock. There is an additional hookup, currently unused. And, of course, the door that leads you OUTSIDE your apartment.

>outside
Street
this is placeholder for street.

>west
Cafe
this is placeholder for cafe.

>inside
Cyberpsace

* * *

>outside
Street
  When you first saw the listing for an apartment on Telegraph Ave, you thought it was a wonderful idea. Night markets! Plays! All the bars a young platypus could ever want to visit!

That was before you got your night shift job. Now, all the activity is merely a reminder of all the things you are no longer able to do. Most of the other nocturnal animals in your city had chosen elsewhere to live, where most of the inhabitants were away at work and they could sleep in peace.

Telegraph was busy at all hours, which made finding sleep difficult.

  A young bat stumbles on the sidewalk, calling out for buyers for the evening edition of the paper. He's emoting with his wings, which draws attention, but gives everyone reason to avoid him to stay out of range.

You decide to do the same.

 Across the street to the WEST is the cafe you often frequent. If you continue SOUTH, you'll reach your office building.

>west
Cafe
 The bell above the door tinkles as you step inside.

 "G'day," says the clerk behind the counter, with a big smile.

A couple patrons glance at you, likely wondering if the weasel was making fun of you. But you've been going here for years, so you chalk it up to fitting the "Australis" theme than anything else.

 While you were indeed hungry, you didn't have the time to kick your webs up and relax, so you better get going if you planned on not angering your boss.

The cafe has several patrons sitting at different tables, a clerk standing behind the counter, and the door to leave in the EAST. You can't help but notice the leyline jack is left unguarded. You're so amazing that you can go INSIDE the leyline network without an item (as you have yet to learn how to use items).

>inside
Cyberspace
this is placeholder for cyberspace.

>outside
Office
this is placeholder for office.

>go inside
Cyberspace
this is placeholder for cyberspace.

>go outside cafe
I only understood you as far as wanting to go outside.

>go to cafe
You can't see any such thing.

>go  outside
Office
this is placeholder for office.

>inside
Cyberspace
this is placeholder for cyberspace.

* * *

>look
Cafe
 The bell above the door tinkles as you step inside.

 While you were indeed hungry, you didn't have the time to kick your webs up and relax, so you better get going if you planned on not angering your boss.

The cafe has several patrons sitting at different tables, a clerk standing behind the counter, and the door to leave in the EAST. You can't help but notice the leyline jack is left unguarded. You're so amazing that you can go INSIDE the leyline network without an item (as you have yet to learn how to use items).

>inside
Cyberspace
this is placeholder for cyberspace.

* * *

>south
Office
  You're able to punch in just in time; your boss won't be able to accuse you of being late this time!

 As you were never taught how to speak, you do not run into any creatures on the way to your closet. Lucky you!

Unlike other animals, you don't mind the dark, enclosed space of the networking closet. The softly-glowing cords of the leyline network create glittering afterimages if you look at one spot for too long.

You have tasks that are your duty to perform, but you aren't capable of remembering what they are.

You're so amazing that you can go INSIDE the leyline network without an item (as you have yet to learn how to use items.). You can also leave the office by going NORTH.

>look
Office
  As you were never taught how to speak, you do not run into any creatures on the way to your closet. Lucky you!

Unlike other animals, you don't mind the dark, enclosed space of the networking closet. The softly-glowing cords of the leyline network create glittering afterimages if you look at one spot for too long.

You have tasks that are your duty to perform, but you aren't capable of remembering what they are.

You're so amazing that you can go INSIDE the leyline network without an item (as you have yet to learn how to use items.). You can also leave the office by going NORTH.

>north
If you clock out now, that'll surely cause issues with your boss. Unfortunately, you are stuck here for the time being.

>south
You move in the dark, but the faint crackle of magic tingles your beak. You remember that continuing in such a direction would result in becoming entangled with the cords and cause quite a mess for yourself.

You, wisely, decide not to.

>inside
Network
  You'll probably never get used to the feeling of tumbling inside-out that always happens whenever you connect to the network...with your mind, because you're so amazing that you don't need items.

 The leyline network is an abstract space, colors and intent swirling in place until a current of energy might rush by and take it from one place to another.

You're one of the lucky few that is able to visualize this space...but not lucky enough to have the aptitude to actually create the spells yourself. Instead, you're nothing more than a glorified guard, poking at suspicious-looking tidepools to find anything that might not supposed to be there.

There are various areas of color you could inspect, but you don't seem to recall how to do that. The only action you're able to leave is by going OUTSIDE of the network.

>north
As the network is an abstract space, it really doesn't conform to concepts such as "up" and "down." You waste time thinking about movement that isn't possible.

* * *

>o
Sorry, that can't be corrected.

>out
Street
  When you first saw the listing for an apartment on Telegraph Ave, you thought it was a wonderful idea. Night markets! Plays! All the bars a young platypus could ever want to visit!

That was before you got your night shift job. Now, all the activity is merely a reminder of all the things you are no longer able to do. Most of the other nocturnal animals in your city had chosen elsewhere to live, where most of the inhabitants were away at work and they could sleep in peace.

Telegraph was busy at all hours, which made finding sleep difficult.

  A tram stops and a stream of creatures jump off, scattering in each direction as they headed to their evening activities. You plan to jump on yourself, but it takes off before you have the chance.

It seems like you'll need to walk to work tonight.

 If you continue SOUTH, you'll reach your office building. 

Across the street to the WEST is the cafe you often frequent.

>west
Cafe
 The bell above the door tinkles as you step inside.

 "G'day," says the clerk behind the counter, with a big smile.

A couple patrons glance at you, likely wondering if the weasel was making fun of you. But you've been going here for years, so you chalk it up to fitting the "Australis" theme than anything else.

 While you were indeed hungry, you didn't have the time to kick your webs up and relax, so you better get going if you planned on not angering your boss.

The cafe has several patrons sitting at different tables, a clerk standing behind the counter, and the door to leave in the EAST. You can't help but notice the leyline jack is left unguarded. You're so amazing that you can go INSIDE the leyline network without an item (as you have yet to learn how to use items).

>in
Network
  You'll probably never get used to the feeling of tumbling inside-out that always happens whenever you connect to the network...with your mind, because you're so amazing that you don't need items.

 The leyline network is an abstract space, colors and intent swirling in place until a current of energy might rush by and take it from one place to another.

You're one of the lucky few that is able to visualize this space...but not lucky enough to have the aptitude to actually create the spells yourself. Instead, you're nothing more than a glorified guard, poking at suspicious-looking tidepools to find anything that might not supposed to be there.

There are various areas of color you could inspect, but you don't seem to recall how to do that. The only action you're able to leave is by going OUTSIDE of the network.

>out
Office
  You're able to punch in just in time; your boss won't be able to accuse you of being late this time!

 As you were never taught how to speak, you do not run into any creatures on the way to your closet. Lucky you!

Unlike other animals, you don't mind the dark, enclosed space of the networking closet. The softly-glowing cords of the leyline network create glittering afterimages if you look at one spot for too long.

You have tasks that are your duty to perform, but you aren't capable of remembering what they are.

You're so amazing that you can go INSIDE the leyline network without an item (as you have yet to learn how to use items.). You can also leave the office by going NORTH.

>north
Street
  Across the street to the WEST is the cafe you often frequent. If you continue SOUTH, you'll reach your office building.

>south
Office
  As you were never taught how to speak, you do not run into any creatures on the way to your closet. Lucky you!

Unlike other animals, you don't mind the dark, enclosed space of the networking closet. The softly-glowing cords of the leyline network create glittering afterimages if you look at one spot for too long.

You have tasks that are your duty to perform, but you aren't capable of remembering what they are.

You're so amazing that you can go INSIDE the leyline network without an item (as you have yet to learn how to use items.). You can also leave the office by going NORTH.

>in
Network
  The leyline network is an abstract space, colors and intent swirling in place until a current of energy might rush by and take it from one place to another.

You're one of the lucky few that is able to visualize this space...but not lucky enough to have the aptitude to actually create the spells yourself. Instead, you're nothing more than a glorified guard, poking at suspicious-looking tidepools to find anything that might not supposed to be there.

There are various areas of color you could inspect, but you don't seem to recall how to do that. The only action you're able to leave is by going OUTSIDE of the network.

>outside
Office
  As you were never taught how to speak, you do not run into any creatures on the way to your closet. Lucky you!

Unlike other animals, you don't mind the dark, enclosed space of the networking closet. The softly-glowing cords of the leyline network create glittering afterimages if you look at one spot for too long.

You have tasks that are your duty to perform, but you aren't capable of remembering what they are.

You're so amazing that you can go INSIDE the leyline network without an item (as you have yet to learn how to use items.). You can also leave the office by going NORTH.

>north
Street
  Across the street to the WEST is the cafe you often frequent. If you continue SOUTH, you'll reach your office building.

>west
Cafe
 The bell above the door tinkles as you step inside.

 While you were indeed hungry, you didn't have the time to kick your webs up and relax, so you better get going if you planned on not angering your boss.

The cafe has several patrons sitting at different tables, a clerk standing behind the counter, and the door to leave in the EAST. You can't help but notice the leyline jack is left unguarded. You're so amazing that you can go INSIDE the leyline network without an item (as you have yet to learn how to use items).

>inside
Network
  The leyline network is an abstract space, colors and intent swirling in place until a current of energy might rush by and take it from one place to another.

You're one of the lucky few that is able to visualize this space...but not lucky enough to have the aptitude to actually create the spells yourself. Instead, you're nothing more than a glorified guard, poking at suspicious-looking tidepools to find anything that might not supposed to be there.

There are various areas of color you could inspect, but you don't seem to recall how to do that. The only action you're able to leave is by going OUTSIDE of the network.

* * *

>s
Office
  You're able to punch in just in time; your boss won't be able to accuse you of being late this time!

 As you were never taught how to speak, you do not run into any creatures on the way to your closet. Lucky you!

Unlike other animals, you don't mind the dark, enclosed space of the networking closet. The softly-glowing cords of the leyline network create glittering afterimages if you look at one spot for too long.

You have tasks that are your duty to perform, but you aren't capable of remembering what they are.

You're so amazing that you can go INSIDE the leyline network without an item (as you have yet to learn how to use items.). You can also leave the office by going NORTH.

>examine clock
A clockwork device used to mark your timecard and log your hours. A necessary evil of the office.

>examine cords
Thin filaments spun from materials harvested from monsters that allow magical energy to be transferred from one place to another. You had to memorize all the colors and the best materials for your certification exam, but you've yet to need to craft your own cables.

>examine network
The carefully-stacked and organized magitek that makes up they leyline network...or at least part of it. Like steam, a complex series of devices step down magic to an amount and strength that can be used by smaller businesses and homes.

>in
Network
  You'll probably never get used to the feeling of tumbling inside-out that always happens whenever you connect to the network...with your mind, because you're so amazing that you don't need items.

 The leyline network is an abstract space, colors and intent swirling in place until a current of energy might rush by and take it from one place to another.

You're one of the lucky few that is able to visualize this space...but not lucky enough to have the aptitude to actually create the spells yourself. Instead, you're nothing more than a glorified guard, poking at suspicious-looking tidepools to find anything that might not supposed to be there.

There are various areas of color you could inspect, but you don't seem to recall how to do that. The only action you're able to leave is by going OUTSIDE of the network. 

A red pool of energy quietly swirls.

A blue pool of energy gives off a faint buzz along your beak.

A green pool of energy is constantly churning and can easily pull you under if you don't approach it with care.

>take all
There are none at all available!

>examine red
A deep pool of tomato-bright energy. You can gauge that there's just about the right amount that had accumulated since your last shift.

>examine blue
A shallow pool of jay-blue energy. Like the bird, there's a wealth of barely-contained momentum just underneath the surface.

>examine green
A deep, deep well of energy. It's more like a river, or an ocean current, and is the backbone of the leyline network...or at least the corner of it that exists within your closet.

* * *

>w
Cafe
 The bell above the door tinkles as you step inside.

 "G'day," says the clerk behind the counter, with a big smile.

A couple patrons glance at you, likely wondering if the weasel was making fun of you. But you've been going here for years, so you chalk it up to fitting the "Australis" theme than anything else.

 While you were indeed hungry, you didn't have the time to kick your webs up and relax, so you better get going if you planned on not angering your boss.

The cafe has several patrons sitting at different tables, a clerk standing behind the counter, and the door to leave in the EAST. 

You can't help but notice the leyline jack is left unguarded on the SOUTH wall.

>eat leyline jack
You cannot eat something inserted into the wall.

>e
Street
   A young bat stumbles on the sidewalk, calling out for buyers for the evening edition of the paper. He's emoting with his wings, which draws attention, but gives everyone reason to avoid him to stay out of range.

You decide to do the same.

 If you continue SOUTH, you'll reach your office building. 

Across the street to the WEST is the cafe you often frequent.

>s
Office
  You're able to punch in just in time; your boss won't be able to accuse you of being late this time!

 As you were never taught how to speak, you do not run into any creatures on the way to your closet. Lucky you!

Unlike other animals, you don't mind the dark, enclosed space of the networking closet. The softly-glowing cords of the leyline network create glittering afterimages if you look at one spot for too long.

You have tasks that are your duty to perform, but you aren't capable of remembering what they are.

When you're ready to begin, you can go INSIDE the network. You can also leave the office by going NORTH. 

The leyline connector is awaiting the start of your shift.

>take all
(connector)
Taken.

>n
Street
   A tram stops and a stream of creatures jump off, scattering in each direction as they headed to their evening activities. You plan to jump on yourself, but it takes off before you have the chance.

It seems like you'll need to walk to work tonight.

 If you continue SOUTH, you'll reach your office building. 

Across the street to the WEST is the cafe you often frequent.

>w
Cafe
 The bell above the door tinkles as you step inside.

 "G'day again," the clerk chirps, and then giggles. "Changed your mind, huh? What can I get you?"

Unfortunately, you have still never learned how to speak, so you cannot answer her.

 While you were indeed hungry, you didn't have the time to kick your webs up and relax, so you better get going if you planned on not angering your boss.

The cafe has several patrons sitting at different tables, a clerk standing behind the counter, and the door to leave in the EAST. 

You can't help but notice the leyline jack is left unguarded on the SOUTH wall.

>unlock leyline jack with connector
You unlock leyline jack.

>s
(first opening leyline jack)

The Network
  You'll probably never get used to the feeling of tumbling inside-out that always happens whenever you connect to the network...with your mind, because you're so amazing that you don't need items.

 The leyline network is an abstract space, colors and intent swirling in place until a current of energy might rush by and take it from one place to another.

You're one of the lucky few that is able to visualize this space...but not lucky enough to have the aptitude to actually create the spells yourself. Instead, you're nothing more than a glorified guard, poking at suspicious-looking tidepools to find anything that might not supposed to be there.

There are various areas of color you could inspect, but you don't seem to recall how to do that. The only action you're able to leave is by going OUTSIDE of the network. 

 A leyline jack is available on the SOUTH wall.

A red pool of energy quietly swirls.

A blue pool of energy gives off a faint buzz along your beak.

A green pool of energy is constantly churning and can easily pull you under if you don't approach it with care.

>out
Office
  As you were never taught how to speak, you do not run into any creatures on the way to your closet. Lucky you!

Unlike other animals, you don't mind the dark, enclosed space of the networking closet. The softly-glowing cords of the leyline network create glittering afterimages if you look at one spot for too long.

You have tasks that are your duty to perform, but you aren't capable of remembering what they are.

When you're ready to begin, you can go INSIDE the network. You can also leave the office by going NORTH.

>eat cords
While a very caprine idea, the hairs and heartstrings wouldn't be very appetizing, so you decline the idea.

>in
test.

* * *

>o
Sorry, that can't be corrected.

>s
You bump into the wall. You are swiftly reminded of how sensitive your beak is, and why it isn't a good idea to run into walls.

>out
Street
  When you first saw the listing for an apartment on Telegraph Ave, you thought it was a wonderful idea. Night markets! Plays! All the bars a young platypus could ever want to visit!

That was before you got your night shift job. Now, all the activity is merely a reminder of all the things you are no longer able to do. Most of the other nocturnal animals in your city had chosen elsewhere to live, where most of the inhabitants were away at work and they could sleep in peace.

Telegraph was busy at all hours, which made finding sleep difficult.

  A tram stops and a stream of creatures jump off, scattering in each direction as they headed to their evening activities. You plan to jump on yourself, but it takes off before you have the chance.

It seems like you'll need to walk to work tonight.

 If you continue SOUTH, you'll reach your office building. 

Across the street to the WEST is the cafe you often frequent.

>s
Office
  You're able to punch in just in time; your boss won't be able to accuse you of being late this time!

 As you were never taught how to speak, you do not run into any creatures on the way to your closet. Lucky you!

Unlike other animals, you don't mind the dark, enclosed space of the networking closet. The softly-glowing cords of the leyline network create glittering afterimages if you look at one spot for too long.

You have tasks that are your duty to perform, but you aren't capable of remembering what they are.

When you're ready to begin, you can go INSIDE the network. You can also leave the office by going NORTH. 

The leyline connector is awaiting the start of your shift.

* * *

>take all
(connector)
Taken.

>in
You take a moment to prepare yourself. You wrap one paw around the cable's end, close your eyes, and then plug it into the hardware.

The Network
  You'll probably never get used to the feeling of tumbling inside-out that always happens whenever you connect to the network...with your mind, because you're so amazing that you don't need items.

 The leyline network is an abstract space, colors and intent swirling in place until a current of energy might rush by and take it from one place to another.

You're one of the lucky few that is able to visualize this space...but not lucky enough to have the aptitude to actually create the spells yourself. Instead, you're nothing more than a glorified guard, inspecting suspicious-looking tidepools to find anything that might not supposed to be there.

You can leave by going OUTSIDE of the network. 

You can't help but notice the leyline jack is left unguarded on the SOUTH wall.

A red pool of energy quietly swirls.

A blue pool of energy gives off a faint buzz along your beak.

A green pool of energy is constantly churning and can easily pull you under if you don't approach it with care.

>inspect red
You inspect the red pool, revealing the magic within.

>use red
You have already inspected this.

>use blue
You inspect the blue pool, revealing the magic within.

>out
Office
  As you were never taught how to speak, you do not run into any creatures on the way to your closet. Lucky you!

Unlike other animals, you don't mind the dark, enclosed space of the networking closet. The softly-glowing cords of the leyline network create glittering afterimages if you look at one spot for too long.

You have tasks that are your duty to perform, but you aren't capable of remembering what they are.

When you're ready to begin, you can go INSIDE the network. You can also leave the office by going NORTH.

>n
Street
   A young bat stumbles on the sidewalk, calling out for buyers for the evening edition of the paper. He's emoting with his wings, which draws attention, but gives everyone reason to avoid him to stay out of range.

You decide to do the same.

 If you continue SOUTH, you'll reach your office building. 

Across the street to the WEST is the cafe you often frequent.

>in
Apartment
  There's a corner for your bathroom-slash-kitchen, complete with a washing basin atop a safe. There's also a brick fireplace, a small bookshelf, your bed, and your alarm clock. There is an additional steam hookup, currently unused. And, of course, the door that leads you OUTSIDE your apartment.

>examine bookshelf
A small, rickety-looking bookshelf. Would be the perfect place to store your knick-knacks, if you had any.

In bookshelf are books and newspaper.

* * *

>north
You bump into the wall. You are swiftly reminded of how sensitive your beak is, and why it isn't a good idea to run into walls.

>outside
Street
  When you first saw the listing for an apartment on Telegraph Ave, you thought it was a wonderful idea. Night markets! Plays! All the bars a young platypus could ever want to visit!

That was before you got your night shift job. Now, all the activity is merely a reminder of all the things you are no longer able to do. Most of the other nocturnal animals in your city had chosen elsewhere to live, where most of the inhabitants were away at work and they could sleep in peace.

Telegraph was busy at all hours, which made finding sleep difficult.

 Across the street to the WEST is the cafe you often frequent. If you continue SOUTH, you'll reach your office building.

>north
You walk for a short while, but are stopped by a road closure. It seems that some hapless laborer had dug without consulting city hall first, resulting in a damaged steam line...and most of the road being torn up.

You turn around and go back to your previous position.

>west
Cafe
 The bell above the door tinkles as you step inside.

 "G'day," says the clerk behind the counter, with a big smile.

A couple patrons glance at you, likely wondering if the weasel was making fun of you. But you've been going here for years, so you chalk it up to fitting the "Australis" theme than anything else.

 While you were indeed hungry, you didn't have the time to kick your webs up and relax, so you better get going if you planned on not angering your boss.

The cafe has several patrons sitting at different tables, a clerk standing behind the counter, and the door to leave in the EAST. You can't help but notice the leyline jack is left unguarded. You're so amazing that you can go INSIDE the leyline network without an item (as you have yet to learn how to use items).

>north
You consider it, but decide not to. It would be unwise to plow into someone's table and ruin their supper.

* * *

>north
As the network is an abstract space, it really doesn't conform to concepts such as "up" and "down." You waste time thinking about movement that isn't possible.

>outside
Office
  You're able to punch in just in time; your boss won't be able to accuse you of being late this time!

 As you were never taught how to speak, you do not run into any creatures on the way to your closet. Lucky you!

Unlike other animals, you don't mind the dark, enclosed space of the networking closet. The softly-glowing cords of the leyline network create glittering afterimages if you look at one spot for too long.

You have tasks that are your duty to perform, but you aren't capable of remembering what they are.

You're so amazing that you can go INSIDE the leyline network without an item (as you have yet to learn how to use items.). You can also leave the office by going NORTH.

>south
You move in the dark, but the faint crackle of magic tingles your beak. You remember that continuing in such a direction would result in becoming entangled with the cords and cause quite a mess for yourself.

You, wisely, decide not to.

* * *

>examine sink
A shallow-ish bowl and matching ewer. Perfect for washing your face in the morning. Or, evening, depending on when you wake up.

In basin is ewer.

>examine ewer
A simple porcelain jug filled with water.

>take all
(ewer)
Taken.

>take all
There are none at all available!

>examine pie safe
A pie safe. The tin panels on the front have holes punched in the design of eucalyptus trees.

>open
(ewer)
It isn't something you can open.

>open pie safe
You open safe, revealing pie.

>take pie
Taken.

>eat pie
You eat pie. Not bad.

>examine pie
You can't see any such thing.

* * *

>examine pie safe
A pie safe. The tin panels on the front have holes punched in the design of eucalyptus trees.

>open pie safe
You open safe, revealing pie.

>examine pie
A personal-sized mealworm pot pie. Makes a perfect start for your day-slash-night.

>eat pie
(first taking pie)
You eat pie. Not bad.

* * *

>examine bookshelf
A small, rickety-looking bookshelf. Would be the perfect place to store your knick-knacks, if you had any.

In bookshelf are books and newspaper.

>take all
ewer: Taken.
books: Taken.
newspaper: Taken.

>examine hookup
One of the ingenious inventions of modern living, it permits pressurized steam into compatible appliances to give them kinetic power.

Some engineer surely lost many nights worth of sleep to design a connection that only allows the emission of steam when a authorized connecting cable is used. Granted, only the utility company has the tools to add or remove the connections, as well as hold the patent for the cables. You understand the issue with this, but you're also not interested in designing your own tools and risking steam burns.

>examine fire place
A brick fireplace. It's the summer, so you won't be needing to use it anytime soon.

>take fireplace
That's hardly portable.

>take bookshelf
That's hardly portable.

>look bookshelf
A small, rickety-looking bookshelf. Would be the perfect place to store your knick-knacks, if you had any.

>examine book
Several books, none notable. There's dime novels, old almanacs, and random volumes of encyclopedias on obscure subjects.

You remind yourself to stop accepting "gifts" from your vulture friend.

>examine paper
Months-old newspapers that you're only holding on to for lighting the fireplace. You haven't needed to in some time, so they're beginning to yellow.

>examine book
Several books, none notable. There's dime novels, old almanacs, and random volumes of encyclopedias on obscure subjects.

You remind yourself to stop accepting "gifts" from your vulture friend.

* * *

>examine clock
A steam-powered alarm clock. The newest model, it costed you a pretty penny, but it means you always wake up in time for work.  Your neighbors aren't super appreciative of this modern convenience, though. Probably because they keep entirely different hours than you do.  

Alarm clock is currently switched off.

>examine alarm
A steam-powered alarm clock. The newest model, it costed you a pretty penny, but it means you always wake up in time for work.  Your neighbors aren't super appreciative of this modern convenience, though. Probably because they keep entirely different hours than you do.  

Alarm clock is currently switched off.

>look books
Several books, none notable. There's dime novels, old almanacs, and random volumes of encyclopedias on obscure subjects.  You remind yourself to stop accepting "gifts" from your vulture friend.

* * *

>examine safe
A pie safe. The tin panels on the front have holes punched in the design of eucalyptus trees.

* * *

>open safe
You open safe, revealing pie.

>take pie
Taken.

>take all
ewer: Taken.
books: Taken.
newspaper: Taken.

>examine hookup
One of the ingenious inventions of modern living, it permits pressurized steam into compatible appliances to give them kinetic power.  Some engineer surely lost many nights worth of sleep to design a connection that only allows the emission of steam when a authorized connecting cable is used. Granted, only the utility company has the tools to add or remove the connections, as well as hold the patent for the cables. You understand the issue with this, but you're also not interested in designing your own tools and risking steam burns.

>outside
Street
  When you first saw the listing for an apartment on Telegraph Ave, you thought it was a wonderful idea. Night markets! Plays! All the bars a young platypus could ever want to visit!

That was before you got your night shift job. Now, all the activity is merely a reminder of all the things you are no longer able to do. Most of the other nocturnal animals in your city had chosen elsewhere to live, where most of the inhabitants were away at work and they could sleep in peace.

Telegraph was busy at all hours, which made finding sleep difficult.

  A young bat stumbles on the sidewalk, calling out for buyers for the evening edition of the paper. He's emoting with his wings, which draws attention, but gives everyone reason to avoid him to stay out of range.

You decide to do the same.

 If you continue SOUTH, you'll reach your office building. 

Across the street to the WEST is the cafe you often frequent.

>examine building
You can't see any such thing.

>examine apartment
Your apartment building. It used to be a sizable home, but has since been divided into smaller units.

>take apartment
That's hardly portable.

>examine crowd
An ever-moving throng of animals going about their day. There're beings from nearly every part of the world who live here, but you don't spot anyone else from Australis.

>take crowd
That's hardly portable.

>eat crowd
That's plainly inedible.

>examine tram
The tram is long gone, but its tracks and the pneumatic tube that powers it remain. If you weren't sensitive to magic, you'd like to think that you'd be a tram operator instead.

>take tram
That's hardly portable.

>take all
There are none at all available!

>examine cafe
A popular cafe. There's several tables out front and animals enjoying an evening meal. A quick peak through the windows shows that, while busy, there's still a few open tables and no line.

>w
Cafe
 The bell above the door tinkles as you step inside.

 "G'day," says the clerk behind the counter, with a big smile.

A couple patrons glance at you, likely wondering if the weasel was making fun of you. But you've been going here for years, so you chalk it up to fitting the "Australis" theme than anything else.

 While you were indeed hungry, you didn't have the time to kick your webs up and relax, so you better get going if you planned on not angering your boss.

The cafe has several patrons sitting at different tables, a clerk standing behind the counter, and the door to leave in the EAST. You can't help but notice the leyline jack is left unguarded. You're so amazing that you can go INSIDE the leyline network without an item (as you have yet to learn how to use items).

>examine counter
A long wooden counter with a clerk standing behind. A pastry case filled with treats invitingly displays its wares.

>examine pastry case
A glass case with shiny brass fittings, both displaying and protecting the delectable treats within.

In pastry case are another pie, pepper tart, wax bottle, grass galette and stargazy roll.

>examine pie
(pie)
A personal-sized mealworm pot pie. Makes a perfect start for your day-slash-night.

>examine another pie
(pie)
A personal-sized mealworm pot pie. Makes a perfect start for your day-slash-night.

>examine  tart
A flaky pastry shell filled with bright-red peppers. Extremely spicy, and only suitable for an avian palate.

>examine bottle
Edible wax formed in the shape of a bottle. Inside is a pale yellow liquid. The nectar is a favorite of hummingbirds, lories, and bears.

>examine galette
Folded pastry around artfully arranged grasses. Aggressively herbaceous and rough on the teeth. Luckily for you, you have none.

>examine roll
Flaky pastry rolled around a fish, leaving its head exposed. Probably an unnerving sight for herbivores.

>take all
another pie: Pastry case isn't open.
pepper tart: Pastry case isn't open.
wax bottle: Pastry case isn't open.
grass galette: Pastry case isn't open.
stargazy roll: Pastry case isn't open.

>examine jack
A port to the leyline network. Probably not a good idea that anyone can access it, but not everyone has the capacity to do so.

>look
Cafe
 The bell above the door tinkles as you step inside.

 "G'day again," the clerk chirps, and then giggles. "Changed your mind, huh? What can I get you?"

Unfortunately, you have still never learned how to speak, so you cannot answer her.

 While you were indeed hungry, you didn't have the time to kick your webs up and relax, so you better get going if you planned on not angering your boss.

The cafe has several patrons sitting at different tables, a clerk standing behind the counter, and the door to leave in the EAST. You can't help but notice the leyline jack is left unguarded. You're so amazing that you can go INSIDE the leyline network without an item (as you have yet to learn how to use items).

* * *

>switch on alarm
You reset your alarm. Now at least you won't need to worry about doing it when you get home after work.

>switch off clock
You enjoy the click of the clockwork, but you'll need to turn it back on eventually. Or maybe you'll enjoy the risk of sleeping in tomorrow.

>eat clock
While a very caprine idea, the steam burns wouldn't be very appetizing, so you decline the idea.

>eat bed
While you had a dream like this once, it wasn't a very pleasant one. Besides, you already have food available.

>eat pie safe
Pie safes are for storing food, not being food!

>open pie safe
You open safe, revealing pie.

* * *

>take pie
Taken.

>eat pie
Yum! Protein is the best way to start the day, as your mum always said.

>i
You are carrying nothing.

>x basin
A shallow-ish bowl and matching ewer. Perfect for washing your face in the morning. Or, evening, depending on when you wake up.

In basin is ewer.

>eat basin
While a very caprine idea, the porcelain wouldn't be very appetizing, so you decline the idea.

>eat ewer
While a very caprine idea, the porcelain wouldn't be very appetizing, so you decline the idea.

>eat fireplace
While a very caprine idea, the brick wouldn't be very appetizing, so you decline the idea.

>eat bookshelf
While a very caprine idea, the splinters wouldn't be very appetizing, so you decline the idea.

>eat hookup
While a very caprine idea, the steam burns wouldn't be very appetizing, so you decline the idea.

>take all
ewer: Taken.
books: Taken.
newspaper: Taken.

>eat books
While a very caprine idea, the paper cuts wouldn't be very appetizing, so you decline the idea.

>eat newspaper
While a very caprine idea, the paper cuts wouldn't be very appetizing, so you decline the idea.

* * *

>open safe
You open safe, revealing pie.

>take all
pie: Taken.
ewer: Taken.
books: Taken.
newspaper: Taken.

>east
You bump into the wall. You are swiftly reminded of how sensitive your beak is, and why it isn't a good idea to run into walls.

>out
Street
  When you first saw the listing for an apartment on Telegraph Ave, you thought it was a wonderful idea. Night markets! Plays! All the bars a young platypus could ever want to visit!

That was before you got your night shift job. Now, all the activity is merely a reminder of all the things you are no longer able to do. Most of the other nocturnal animals in your city had chosen elsewhere to live, where most of the inhabitants were away at work and they could sleep in peace.

Telegraph was busy at all hours, which made finding sleep difficult.

  A young bat stumbles on the sidewalk, calling out for buyers for the evening edition of the paper. He's emoting with his wings, which draws attention, but gives everyone reason to avoid him to stay out of range.

You decide to do the same.

 If you continue SOUTH, you'll reach your office building. 

Across the street to the WEST is the cafe you often frequent.

>eat building
While a very caprine idea, the concrete wouldn't be very appetizing, so you decline the idea.

>eat crowd
That's plainly inedible.

>eat trams
You can't see any such thing.

>eat tram
While a very caprine idea, the steel wouldn't be very appetizing, so you decline the idea.

>eat cafe
While a very caprine idea, the concrete wouldn't be very appetizing, so you decline the idea.

>east
  You walk for a short while, but are stopped by a road closure. It seems that some hapless laborer had dug without consulting city hall first, resulting in a damaged steam line...and most of the road being torn up.

You turn around and go back to your previous position.

>west
Cafe
 The bell above the door tinkles as you step inside.

 "G'day," says the clerk behind the counter, with a big smile.

A couple patrons glance at you, likely wondering if the weasel was making fun of you. But you've been going here for years, so you chalk it up to fitting the "Australis" theme than anything else.

 While you were indeed hungry, you didn't have the time to kick your webs up and relax, so you better get going if you planned on not angering your boss.

The cafe has several patrons sitting at different tables, a clerk standing behind the counter, and the door to leave in the EAST. 

You can't help but notice the leyline jack is left unguarded.

>eat counter
While a very caprine idea, the splinters wouldn't be very appetizing, so you decline the idea.

>eat jack
That's plainly inedible.

>w
You consider it, but decide not to. It would be unwise to plow into someone's table and ruin their supper.

>e
Street
   A tram stops and a stream of creatures jump off, scattering in each direction as they headed to their evening activities. You plan to jump on yourself, but it takes off before you have the chance.

It seems like you'll need to walk to work tonight.

 If you continue SOUTH, you'll reach your office building. 

Across the street to the WEST is the cafe you often frequent.

>s
Office
  You're able to punch in just in time; your boss won't be able to accuse you of being late this time!

 As you were never taught how to speak, you do not run into any creatures on the way to your closet. Lucky you!

Unlike other animals, you don't mind the dark, enclosed space of the networking closet. The softly-glowing cords of the leyline network create glittering afterimages if you look at one spot for too long.

You have tasks that are your duty to perform, but you aren't capable of remembering what they are.

When you're ready to begin, you can go INSIDE the network. You can also leave the office by going NORTH. 

The leyline connector is awaiting the start of your shift.

>take all
connector: Taken.

>inside
test.

>n
Street
   A young bat stumbles on the sidewalk, calling out for buyers for the evening edition of the paper. He's emoting with his wings, which draws attention, but gives everyone reason to avoid him to stay out of range.

You decide to do the same.

 If you continue SOUTH, you'll reach your office building. 

Across the street to the WEST is the cafe you often frequent.

>w
Cafe
 The bell above the door tinkles as you step inside.

 "G'day again," the clerk chirps, and then giggles. "Changed your mind, huh? What can I get you?"

Unfortunately, you have still never learned how to speak, so you cannot answer her.

 While you were indeed hungry, you didn't have the time to kick your webs up and relax, so you better get going if you planned on not angering your boss.

The cafe has several patrons sitting at different tables, a clerk standing behind the counter, and the door to leave in the EAST. 

You can't help but notice the leyline jack is left unguarded.

>unlock leyline jack with connector
You unlock leyline jack.

>leyline jack
That's not a verb I recognise.

>go inside
You consider it, but decide not to. It would be unwise to plow into someone's table and ruin their supper.

>s
(first opening leyline jack)

The Network
  You'll probably never get used to the feeling of tumbling inside-out that always happens whenever you connect to the network...with your mind, because you're so amazing that you don't need items.

 The leyline network is an abstract space, colors and intent swirling in place until a current of energy might rush by and take it from one place to another.

You're one of the lucky few that is able to visualize this space...but not lucky enough to have the aptitude to actually create the spells yourself. Instead, you're nothing more than a glorified guard, poking at suspicious-looking tidepools to find anything that might not supposed to be there.

There are various areas of color you could inspect, but you don't seem to recall how to do that. The only action you're able to leave is by going OUTSIDE of the network. 

 A leyline jack is available.

A red pool of energy quietly swirls.

A blue pool of energy gives off a faint buzz along your beak.

A green pool of energy is constantly churning and can easily pull you under if you don't approach it with care.

>x
What do you want to examine?

>out
Office
  As you were never taught how to speak, you do not run into any creatures on the way to your closet. Lucky you!

Unlike other animals, you don't mind the dark, enclosed space of the networking closet. The softly-glowing cords of the leyline network create glittering afterimages if you look at one spot for too long.

You have tasks that are your duty to perform, but you aren't capable of remembering what they are.

When you're ready to begin, you can go INSIDE the network. You can also leave the office by going NORTH.

>eat clock
While it would resolve your issues with the device itself, you would then need to greet your boss to manage your hours. As you have yet to learn how to speak, this is impossible, so it'd be best to table this idea.

>eat cords
That's plainly inedible.

>eat connector
This singular cable is worth more than your yearly salary, so that would be a very unwise decision.

>i
You are carrying:
  connector
  newspaper
  books
  ewer
  pie

>eat network
As it is many times your volume and mass, this would be impossible.

>in
test.

>n
Street
   A tram stops and a stream of creatures jump off, scattering in each direction as they headed to their evening activities. You plan to jump on yourself, but it takes off before you have the chance.

It seems like you'll need to walk to work tonight.

 If you continue SOUTH, you'll reach your office building. 

Across the street to the WEST is the cafe you often frequent.

>w
Cafe
 The bell above the door tinkles as you step inside.

 "Hey," the clerk says. "You feeling okay? If you need a glass of water or something, you can just ask."

You still don't answer her, which she acknowledges by glancing away nervously. She busies herself with something behind the counter you can't see.

 While you were indeed hungry, you didn't have the time to kick your webs up and relax, so you better get going if you planned on not angering your boss.

The cafe has several patrons sitting at different tables, a clerk standing behind the counter, and the door to leave in the EAST. 

 A leyline jack is available.

>s
The Network
  The leyline network is an abstract space, colors and intent swirling in place until a current of energy might rush by and take it from one place to another.

You're one of the lucky few that is able to visualize this space...but not lucky enough to have the aptitude to actually create the spells yourself. Instead, you're nothing more than a glorified guard, poking at suspicious-looking tidepools to find anything that might not supposed to be there.

There are various areas of color you could inspect, but you don't seem to recall how to do that. The only action you're able to leave is by going OUTSIDE of the network. 

 A leyline jack is available.

A red pool of energy quietly swirls.

A blue pool of energy gives off a faint buzz along your beak.

A green pool of energy is constantly churning and can easily pull you under if you don't approach it with care.

>eat red
You cannot eat an abstract concept.

>eat green
You cannot eat an abstract concept.

>eat blue
You cannot eat an abstract concept.

* * *

>out
Street
  When you first saw the listing for an apartment on Telegraph Ave, you thought it was a wonderful idea. Night markets! Plays! All the bars a young platypus could ever want to visit!

That was before you got your night shift job. Now, all the activity is merely a reminder of all the things you are no longer able to do. Most of the other nocturnal animals in your city had chosen elsewhere to live, where most of the inhabitants were away at work and they could sleep in peace.

Telegraph was busy at all hours, which made finding sleep difficult.

  A tram stops and a stream of creatures jump off, scattering in each direction as they headed to their evening activities. You plan to jump on yourself, but it takes off before you have the chance.

It seems like you'll need to walk to work tonight.

 If you continue SOUTH, you'll reach your office building. You can also go back INSIDE your apartment. 

Across the street to the WEST is the cafe you often frequent.

>eat crowd
Platypi aren't known for being apex predators...besides you're not hungry.

>in
Apartment
  There's a corner for your bathroom-slash-kitchen, complete with a washing basin atop a safe. There's also a brick fireplace, a small bookshelf, your bed, and your alarm clock. There is an additional steam hookup, currently unused. And, of course, the door that leads you OUTSIDE your apartment.

>use safe
You open safe, revealing pie.

>take all
pie: Taken.
ewer: Taken.
books: Taken.
newspaper: Taken.

>eat pie
Yum! Protein is the best way to start the day, as your mum always said.

>out
Street
   A tram stops and a stream of creatures jump off, scattering in each direction as they headed to their evening activities. You plan to jump on yourself, but it takes off before you have the chance.

It seems like you'll need to walk to work tonight.

 If you continue SOUTH, you'll reach your office building. 

Across the street to the WEST is the cafe you often frequent.

>eat crowd
Platypi aren't known for being apex predators...besides you're not hungry.

* * *

>s
Office
  You're able to punch in just in time; your boss won't be able to accuse you of being late this time!

 As you were never taught how to speak, you do not run into any creatures on the way to your closet. Lucky you!

Unlike other animals, you don't mind the dark, enclosed space of the networking closet. The softly-glowing cords of the leyline network create glittering afterimages if you look at one spot for too long.

You have tasks that are your duty to perform, but you aren't capable of remembering what they are.

When you're ready to begin, you can go INSIDE the network. You can also leave the office by going NORTH. 

The leyline connector is awaiting the start of your shift.

* * *

>take all
(connector)
Taken.

>use connector
This is merely a cable, so it needs to be used to "unlock" access to a leyline jack.

>in
You take a moment to prepare yourself. You wrap one paw around the cable's end, close your eyes, and then plug it into the hardware.

The Network
  You'll probably never get used to the feeling of tumbling inside-out that always happens whenever you connect to the network...with your mind, because you're so amazing that you don't need items.

 The leyline network is an abstract space, colors and intent swirling in place until a current of energy might rush by and take it from one place to another.

You're one of the lucky few that is able to visualize this space...but not lucky enough to have the aptitude to actually create the spells yourself. Instead, you're nothing more than a glorified guard, inspecting suspicious-looking tidepools to find anything that might not supposed to be there.

You can leave by going OUTSIDE of the network. 

You can't help but notice the leyline jack is left unguarded on the SOUTH wall.

A red pool of energy quietly swirls.

A blue pool of energy gives off a faint buzz along your beak.

A green pool of energy is constantly churning and can easily pull you under if you don't approach it with care.

>use red
You cannot use red pool.

>inspect red
You inspect the red pool, revealing the magic within.

>x red
A deep pool of tomato-bright energy. You can gauge that there's just about the right amount that had accumulated since your last shift.

>close red
It isn't something you can close.

>open red
It isn't something you can open.

>inspect red
You inspect the red pool, revealing the magic within.

* * *

>take
(connector)
Taken.

>in
You take a moment to prepare yourself. You wrap one paw around the cable's end, close your eyes, and then plug it into the hardware.

The Network
  You'll probably never get used to the feeling of tumbling inside-out that always happens whenever you connect to the network...with your mind, because you're so amazing that you don't need items.

 The leyline network is an abstract space, colors and intent swirling in place until a current of energy might rush by and take it from one place to another.

You're one of the lucky few that is able to visualize this space...but not lucky enough to have the aptitude to actually create the spells yourself. Instead, you're nothing more than a glorified guard, inspecting suspicious-looking tidepools to find anything that might not supposed to be there.

You can leave by going OUTSIDE of the network. 

You can't help but notice the leyline jack is left unguarded on the SOUTH wall.

A red pool of energy quietly swirls.

A blue pool of energy gives off a faint buzz along your beak.

A green pool of energy is constantly churning and can easily pull you under if you don't approach it with care.

* * *

>inspect red
You inspect the red pool, revealing the magic within.

>inspect red
You have already inspected this.

>examine red
A deep pool of tomato-bright energy. You can gauge that there's just about the right amount that had accumulated since your last shift.

In red pool is redInfo.

* * *

>x red
A deep pool of tomato-bright energy. You can gauge that there's just about the right amount that had accumulated since your last shift.

>inspect red
You inspect the red pool, revealing the magic within.

* * *

>inspect red
You have already inspected this.

>use red
A deep pool of tomato-bright energy. You can gauge that there's just about the right amount that had accumulated since your last shift.

In red pool is redInfo.

* * *

>use red
You inspect the red pool, revealing the magic within.

>use red
(red pool)
A deep pool of tomato-bright energy. You can gauge that there's just about the right amount that had accumulated since your last shift.

In red pool is red magic.

>examine red info
You can't see any such thing.

>examine redInfo
You can't see any such thing.

>x red magic
This is a long descript.

* * *

>enter bed
You slip under the covers. Your bed is still warm from your sleeping body.

Apartment (in bed)
  There's a corner for your bathroom-slash-kitchen, complete with a washing basin atop a safe. There's also a brick fireplace, a small bookshelf, your bed, and your alarm clock. There is an additional steam hookup, currently unused. And, of course, the door that leads you OUTSIDE your apartment. 

But you're already in bed.

>exit
You get out of bed.

Apartment
  There's a corner for your bathroom-slash-kitchen, complete with a washing basin atop a safe. There's also a brick fireplace, a small bookshelf, your bed, and your alarm clock. There is an additional steam hookup, currently unused. And, of course, the door that leads you OUTSIDE your apartment.

* * *

>enter bed
You slip under the covers. Your bed is still warm from your sleeping body.

Apartment (in bed)
  There's a corner for your bathroom-slash-kitchen, complete with a washing basin atop a safe. There's also a brick fireplace, a small bookshelf, your bed, and your alarm clock. There is an additional steam hookup, currently unused. And, of course, the door that leads you OUTSIDE your apartment. 

But you're already in bed.

>exit
You leave your bed, messing up the covers once again.

>make bed
I only understood you as far as wanting to make.

>making bed
That's not a verb I recognise.

* * *

>enter bed
You slip under the covers. Your bed is still warm from your sleeping body.

Apartment (in bed)
  There's a corner for your bathroom-slash-kitchen, complete with a washing basin atop a safe. There's also a brick fireplace, a small bookshelf, your bed, and your alarm clock. There is an additional steam hookup, currently unused. And, of course, the door that leads you OUTSIDE your apartment. 

But you're already in bed.

>exit bed
I only understood you as far as wanting to exit.

>exit
You leave your bed, messing up the covers once again.

* * *

>make bed
You made your bed! Your mother would be very proud.

>make
You must supply a noun.

>make bed
I only understood you as far as wanting to make.

>make the bed
I only understood you as far as wanting to make.

>enter bed
You slip under the covers. Your bed is still warm from your sleeping body.

Apartment (in bed)
  There's a corner for your bathroom-slash-kitchen, complete with a washing basin atop a safe. There's also a brick fireplace, a small bookshelf, your bed, and your alarm clock. There is an additional steam hookup, currently unused. And, of course, the door that leads you OUTSIDE your apartment. 

But you're already in bed.

* * *

>make bed
You made your bed! Your mother would be very proud.

>enter bed
You slip under the covers. Your bed is still warm from your sleeping body.

Apartment (in bed)
  There's a corner for your bathroom-slash-kitchen, complete with a washing basin atop a safe. There's also a brick fireplace, a small bookshelf, your bed, and your alarm clock. There is an additional steam hookup, currently unused. And, of course, the door that leads you OUTSIDE your apartment. 

But you're already in bed.

* * *

>exit
You leave your bed, messing up the covers once again.

>make bed
You made your bed! Your mother would be very proud.

>make bed
You cannot make the bed, as it is not an unmade bed.

>sleep
You are not sleepy. Besides, you need to go to work, so sleeping is a poor choice.

>out
Street
  When you first saw the listing for an apartment on Telegraph Ave, you thought it was a wonderful idea. Night markets! Plays! All the bars a young platypus could ever want to visit!

That was before you got your night shift job. Now, all the activity is merely a reminder of all the things you are no longer able to do. Most of the other nocturnal animals in your city had chosen elsewhere to live, where most of the inhabitants were away at work and they could sleep in peace.

Telegraph was busy at all hours, which made finding sleep difficult.

  A tram stops and a stream of creatures jump off, scattering in each direction as they headed to their evening activities. You plan to jump on yourself, but it takes off before you have the chance.

It seems like you'll need to walk to work tonight.

 If you continue SOUTH, you'll reach your office building. 

Across the street to the WEST is the cafe you often frequent.

>sleep
This isn't a suitable place to fall asleep.

* * *

>use bed
You slip under the covers. Your bed is still warm from your sleeping body.

Apartment (in bed)
  There's a corner for your bathroom-slash-kitchen, complete with a washing basin atop a safe. There's also a brick fireplace, a small bookshelf, your bed, and your alarm clock. There is an additional steam hookup, currently unused. And, of course, the door that leads you OUTSIDE your apartment. 

But you're already in bed.

>exit bed
I only understood you as far as wanting to exit.

* * *

>exit
You leave your bed, messing up the covers once again.

>use alarm clock
You reset your alarm. Now at least you won't need to worry about doing it when you get home after work.

>use alarm clock
That's already on.

* * *

>use basin
You cannot use basin.

>use ewer
You pour water into the basin.

* * *

I beg your pardon?

* * *

>take ewer
Taken.

>out
Street
  When you first saw the listing for an apartment on Telegraph Ave, you thought it was a wonderful idea. Night markets! Plays! All the bars a young platypus could ever want to visit!

That was before you got your night shift job. Now, all the activity is merely a reminder of all the things you are no longer able to do. Most of the other nocturnal animals in your city had chosen elsewhere to live, where most of the inhabitants were away at work and they could sleep in peace.

Telegraph was busy at all hours, which made finding sleep difficult.

  A tram stops and a stream of creatures jump off, scattering in each direction as they headed to their evening activities. You plan to jump on yourself, but it takes off before you have the chance.

It seems like you'll need to walk to work tonight.

 If you continue SOUTH, you'll reach your office building. 

Across the street to the WEST is the cafe you often frequent.

>use ewer
Pouring out the water would be terribly rude, so you decide not to.

>in
Apartment
  There's a corner for your bathroom-slash-kitchen, complete with a washing basin atop a safe. There's also a brick fireplace, a small bookshelf, your bed, and your alarm clock. There is an additional steam hookup, currently unused. And, of course, the door that leads you OUTSIDE your apartment.

>use ewer
You pour water into the basin.

>use ewer
You cannot use ewer.

* * *

>use ewer
You pour water into the basin.

>use ewer
There's nothing to pour out.

>use fireplace
you cannot use fireplace.

>use bed
You slip under the covers. Your bed is still warm from your sleeping body.

Apartment (in bed)
  There's a corner for your bathroom-slash-kitchen, complete with a washing basin atop a safe. There's also a brick fireplace, a small bookshelf, your bed, and your alarm clock. There is an additional steam hookup, currently unused. And, of course, the door that leads you OUTSIDE your apartment. 

But you're already in bed.

* * *

>exit bed
I only understood you as far as wanting to exit.

>use safe
You open safe, revealing pie.

>use safe
That's already open.

>use clock
You reset your alarm. Now at least you won't need to worry about doing it when you get home after work.

* * *

>use ewer
There's nothing to pour out.

>use basin
You splash water onto your face. Refreshing!

>use basin
You've already use this. Splashing dirty water onto your face wouldn't be very productive.

>use safe
You open safe, revealing pie.

>use pie
(first taking pie)
Yum! Protein is the best way to start the day, as your mum always said.

* * *

>inspect bed
You can only inspect magic.

* * *

>take all
ewer: Taken.
books: Taken.
newspaper: Taken.

>s
You bump into the wall. You are swiftly reminded of how sensitive your beak is, and why it isn't a good idea to run into walls.

>out
Street
  When you first saw the listing for an apartment on Telegraph Ave, you thought it was a wonderful idea. Night markets! Plays! All the bars a young platypus could ever want to visit!

That was before you got your night shift job. Now, all the activity is merely a reminder of all the things you are no longer able to do. Most of the other nocturnal animals in your city had chosen elsewhere to live, where most of the inhabitants were away at work and they could sleep in peace.

Telegraph was busy at all hours, which made finding sleep difficult.

  A young bat stumbles on the sidewalk, calling out for buyers for the evening edition of the paper. He's emoting with his wings, which draws attention, but gives everyone reason to avoid him to stay out of range.

You decide to do the same.

 If you continue SOUTH, you'll reach your office building. You can also go back INSIDE your apartment. 

Across the street to the WEST is the cafe you often frequent.

>s
Office
  You're able to punch in just in time; your boss won't be able to accuse you of being late this time!

 As you were never taught how to speak, you do not run into any creatures on the way to your closet. Lucky you!

Unlike other animals, you don't mind the dark, enclosed space of the networking closet. The softly-glowing cords of the leyline network create glittering afterimages if you look at one spot for too long.

You have tasks that are your duty to perform, but you aren't capable of remembering what they are.

When you're ready to begin, you can go INSIDE the network. You can also leave the office by going NORTH. 

The leyline connector is awaiting the start of your shift.

* * *

>inspect red
You inspect the red pool, revealing the magic within.

>inspect red
(red pool)
A deep pool of tomato-bright energy. You can gauge that there's just about the right amount that had accumulated since your last shift.

In red pool is red magic.

>x red magic
You imagine your paw dipping into the red magic. Each drop feels as it should; they accumulate, like dewdrops on a spiderweb, as magic moves through the leylines. Too much or too little would be a sign that something is wrong, but there's just the amount that you'd expect between your shifts.

>x green pool
A deep, deep well of energy. It's more like a river, or an ocean current, and is the backbone of the leyline network...or at least the corner of it that exists within your closet.

In green pool is green magic.

>x green magic
bbbbbbbbbb.

* * *

>x self
You are a platypus, one of the two kinds of egg-laying mammals. Like all mammals, you stand tall on two legs and can manipulate objects with your paws.

You, though, have webbed paws, which can make manipulations difficult. But you do have a sensitive beak.

>x webs
Thin membranes stretch between each digit of your paws, making you very good at swimming and scooping water.

Unfortunately, it also means that you can't buy factory-made gloves and certain tools. You're able to manipulate items well enough, but every so often you encounter a situation where you're reminded this city wasn't designed for animals like you.

>x beak
A slightly-rubbery blunt beak makes up the end of your face. It's a little like a duck's, but dark and highly sensitive.

Your ancient ancestors used their beaks to hunt for prey in the water, sensing the magic that's within all living things. This isn't very useful for city living, but it does mean you have a natural aptitude for magic...and the lucrative careers that brings.

>take beak
That seems to be a part of yourself.

>out
Street
  When you first saw the listing for an apartment on Telegraph Ave, you thought it was a wonderful idea. Night markets! Plays! All the bars a young platypus could ever want to visit!

That was before you got your night shift job. Now, all the activity is merely a reminder of all the things you are no longer able to do. Most of the other nocturnal animals in your city had chosen elsewhere to live, where most of the inhabitants were away at work and they could sleep in peace.

Telegraph was busy at all hours, which made finding sleep difficult.

  A young bat stumbles on the sidewalk, calling out for buyers for the evening edition of the paper. He's emoting with his wings, which draws attention, but gives everyone reason to avoid him to stay out of range.

You decide to do the same.

 If you continue SOUTH, you'll reach your office building. You can also go back INSIDE your apartment. 

Across the street to the WEST is the cafe you often frequent.

>x self
You are a platypus, one of the two kinds of egg-laying mammals. Like all mammals, you stand tall on two legs and can manipulate objects with your paws.

You, though, have webbed paws, which can make manipulations difficult. But you do have a sensitive beak.

>x beak
A slightly-rubbery blunt beak makes up the end of your face. It's a little like a duck's, but dark and highly sensitive.

Your ancient ancestors used their beaks to hunt for prey in the water, sensing the magic that's within all living things. This isn't very useful for city living, but it does mean you have a natural aptitude for magic...and the lucrative careers that brings.

* * *

>examine self
You are a platypus, one of the two kinds of egg-laying mammals. Like all mammals, you stand tall on two legs and can manipulate objects with your paws.

You, though, have webbed paws, which can make manipulations difficult. But you do have a sensitive beak.

>examine paws
Thin membranes stretch between each digit of your paws, making you very good at swimming and scooping water.

Unfortunately, it also means that you can't buy factory-made gloves and certain tools. You're able to manipulate items well enough, but every so often you encounter a situation where you're reminded this city wasn't designed for animals like you.

>examine beak
A slightly-rubbery blunt beak makes up the end of your face. It's a little like a duck's, but dark and highly sensitive.

Your ancient ancestors used their beaks to hunt for prey in the water, sensing the magic that's within all living things. This isn't very useful for city living, but it does mean you have a natural aptitude for magic...and the lucrative careers that brings.

>out
Street
  When you first saw the listing for an apartment on Telegraph Ave, you thought it was a wonderful idea. Night markets! Plays! All the bars a young platypus could ever want to visit!

That was before you got your night shift job. Now, all the activity is merely a reminder of all the things you are no longer able to do. Most of the other nocturnal animals in your city had chosen elsewhere to live, where most of the inhabitants were away at work and they could sleep in peace.

Telegraph was busy at all hours, which made finding sleep difficult.

  A tram stops and a stream of creatures jump off, scattering in each direction as they headed to their evening activities. You plan to jump on yourself, but it takes off before you have the chance.

It seems like you'll need to walk to work tonight.

 If you continue SOUTH, you'll reach your office building. You can also go back INSIDE your apartment. 

Across the street to the WEST is the cafe you often frequent.

You can also see paperbat here.

>examine bat
A young fruitbat wearing ink-stained overalls and a sling filled with rolled-up newspapers.

Due to his wings, he only has one long, thumb-like appendage to work with, but he only really needs a powerful pair of lungs to convince other animals to buy his wares.

>talk bat
I didn't understand that sentence.

>talk to bat
The paperbat's ears perk up.

"You want a paper, sir? Fresh off the presses!"

Buying things hasn't been implemented yet, so you'll just have to deal lol.

>w
Cafe
 The bell above the door tinkles as you step inside.

 "G'day," says the clerk behind the counter, with a big smile.

A couple patrons glance at you, likely wondering if the weasel was making fun of you. But you've been going here for years, so you chalk it up to fitting the "Australis" theme than anything else.

 While you were indeed hungry, you didn't have the time to kick your webs up and relax, so you better get going if you planned on not angering your boss.

The cafe has several patrons sitting at different tables, a clerk standing behind the counter, and the door to leave in the EAST. 

You can't help but notice the leyline jack is left unguarded on the SOUTH wall.

>look clerk
You can't see any such thing.

>examine clerk
You can't see any such thing.

>examine Clerk
You can't see any such thing.